11111111111111111
1P000010001000101
100110111E0010001
10010011101011101
11011110001010101
1000C0201010001E1
11111111111111111
