1P0000100010001C1
1011101C100010001
1001C011101011101
1101111000101C101
1C0000001C10001E1
11111111111111111
